...............
...............
...........#...
...............
......##.......
.z.........z...
........z......
...............
....#..........
....#..........
...............
............##.
..p.........##.
............##.
...............